111111
100001
1PEC01
111111
111111

111111
100001
1PEC01
111111
111111
