1111111111
1C00000001
111C101011
11111010P1
1C1C101111
1000000C01
1110111C11
11100C1111
1E00100C11
1111111111
