1111111111
10001010P1
110101C001
1000001001
100001C0E1
10000000C1
1111111111
