111111111
110001P11
111111111
110000001
10C010001
1E1111111
111111111