111111111111111111111111111111
1P00001000001000C00100000000E1
10C1001000C0100C010010C0000001
101101100C01000111001000000001
101100000010C00001100111101011
100010C00000000001C010001C1011
1000100000C0000001100100011001
1000C111000001110010010C000101
100010C0011111C100100110010001
1011100000100001000001C01C1001
101C1010010011011C000110001001
101000101000C1001C100010100001
101111C10000001001101001111101
100C1000000C000100C0010000C001
111111111111111111111111111111