1111111111
1P0000M0E1
1011010011
1C0C000M01
1011111011
1M000C0001
1111111111