1111111111
10E0100P01
1M0000C001
1000001001
100001C001
1000000001
1111111111