111111111111111111111111111111
1P00001000001000C00100000000E1
10C100100MC0100C010010C00M0001
101101100C01000111M01000000001
101100000010C00001100111101011
100010C0M00000M001C010001C1011
1M00100000C0000001100100011001
1000C11100M00111001M010C000101
100010C0011111C100100110010001
1011100M00100001000001C01C1001
101C1010010011011C000110001001
101000101000C1001C100010100001
101111C10M00001001101001111101
100C1M00000C0M0100C0010000C001
111111111111111111111111111111